....╔══════╗...........
═╗..║......║......█....
.╚══╝..╔═══╣...╗..║....
.......║...╚═╦═╝╚╦╝....
..╔════╣.....║...║.....
..╚══..║.....╚═══╝.....